11111111111111111111
10001000000001000001
10101111111101011101
30101000010001000101
11101001110111110101
10001000000100000101
10111111010101111101
10100000010101000101
10101111011101010101
10000001010001010101
11111111010111011101
10000100010001010001
11110101111101010111
10010000000001010001
10010111111100011101
11010111101101110001
11010100001000010101
11011101111111010111
10000000000000010002
11111111111111111111